9,1,5,1,1,1,7,11
12,6,11,10,10,10,9,2
15,9,2,10,8,6,10,10
9,6,10,10,10,13,0,2
10,11,10,10,8,5,2,14
10,10,10,10,8,5,4,3
10,10,10,10,10,11,13,2
14,14,12,4,4,4,7,14
